1111111
1P111C1
10C0C01
1111111