1111111111111111111111111
10010000000C0000000000001
1000011111001000000000001
1P0011E000001000000000001
1111111111111111111100001
1000000000000000000000001
10000000000000000000C0001
1111111111111111111100001
1000000000000000000000001
10000000000000000000C0001
1111111111111111111100001
1000000000000000000000001
10000000000000000000C0001
1111111111111111111111111