1111111
1P11C11
11E1111
1111111