111111111111111111111111111111111111111111111111111111
1C0000010011111111111111111111111111111111111111111111
111111010011111111111111111111111111111111111111111111
100000010001111111111111111111111111111111111111110001
10111111000000000000000000000000P000000000000000000001
1000000100000111111111111111CCCCCCCCCCCCCCC11111111111
11111101000000000001000000000000000000000000001CCCCCC1
10000001000000000001000000000000000000000000001CCCCCC1
10111111000000000001000000000000000000000000001CCCCCC1
10000000000000000001000000000000000000000000001CCCCCC1
111111111111101111111111011111111101111111111011111111
1111111111111010000000000000000000000000000000000000C1
111111111111101111111111011111111111111111111111111111
111111111111101CCCCCCCC1010000000000000000000000000001
111111111111101CCCCCCCC1010000000000000000000000000001
111111111111101CCCCCCCC1011111111111111111111111111111
111111111111101CCCCCCCC1000011111111111111111111111111
1111111111111C1CCCCCCCC1010011111111111111111111111111
1111111111111C1CCCCCCCC1010001111111111111111111111111
1111111111111C1CCCCCCCC1010001111111111111111111111111
1111111111111C1CCCCCCCC1010001111111111111111111111111
1111111111111C1CCCCCCCC1E10011111111111111111111111111
111111111111101C11111111110011111111111111111111111111
111111111111101E111111111100000000000000000000000000E1
111111111111101011111111110011111111111111111111111111
111111111111101011111111110011111111111111111111111111
111111111111101000000000000011111111111111111111111111
1E0000000000001E11111111110011111111111111111111111111
111111111111111111111111111111111111111111111111111111